 1
101       1111111111111111111111111
 1       11000000000110000000000001
        10110000011100000000000011
        1001000000000000000000001
111111111011000001110000000000001
100000000011000001110111111111111
11110111110111011100000010001       1
11110111111111011101010010001      1N1
11000000110101011100000010001       1
10000000000000001100000010001
10000000000000001101010010001
1100000111010101111101111000111
11110111 1110101 101111010001
11111111 1111111 111111111111