NO ./textures/walkstone.xpm
WE ./textures/grass.xpm
EA ./textures/forest.xpm
SO ./textures/bookshelf.xpm

C 170,250,255


F      134,1,255











111111111111
100000000001
1000000N0001
100000000001
111111111111