NO ./textures/walkstone.xpm
SO ./textures/walkstone.xpm
WE ./textures/walkstone.xpm
EA ./textures/walkstone.xpm





C 0,0,0
F 255,255,255


1111111111111111111111111111111111
1000000000000000000000001000000001
100000000000000000000000D000000001
100N000000000000000000001000000001
1111111111111111111111111111111111