NO ./textures/walkstone.xpm
WE ./textures/walkstone.xpm
EA ./textures/walkstone.xpm


SO ./textures/walkstone.xpm

C 0,0,-12
F 134,1,255

1111111111111
10000000N0001
1000000111101
1000001  1001
100000111101
11111111111111111111111111111111

1111
1001
1111