NO ./textures/walkstone.xpm
WE ./textures/leavesop.xpm
SO ./textures/bookshelf.xpm
EA ./textures/forest.xpm

F 134,1,255
C 170,250,255













111111111111
100000000001
100000000001
100000000001
100000000001
100000000001
100000000001
100000000001
100000000001
100000000001
100000000001
100000000001
100000000001
100000000001
100000000001
100000000001
100000000001
100000000001
100000000001
11111D111111
100000000001
100000000001
100000000001
100000000001
100000000001
100000000001
100000000001
100000000001
100000000001
100000000001
100000000001
100000000001
100000000001
100000000001
100000000001
100000000001
100000000001
100000000001
100N00000001
111111111111