NO textures/test/north.xpm
SO textures/test/south.xpm
WE textures/test/west.xpm
EA textures/test/east.xpm

F 20,20,200
C 200,200,200

111111111111
100000000101
100011000001
10N011000001
100011000001
100000000001
100000000001
100000000101
100000000101
100000001111
100000001111
100000001111
111111111101
111111111111