NO ./textures/walkstone.xpm
SO ./textures/walkstone.xpm
WE ./textures/walkstone.xpm
EA ./textures/walkstone.xpm

F 200,200,200
C 135,206,235

111111111111
100000000101
100011000001
100011000001
100011000001
100000000001
101100100001                1
101100100101
100000000101
100000011111
100000111111
100000000001
100000000001
100110000001
100110001001
100110001001
100000000001
100000000001
100000000001
111110000001
111110000001
100000001001
10000000D001
100011111001
100011110001
1D1111100001
1N0011000001
111111111111