
SO ./textures/walkstone.xpm
WE ./textures/walkstone.xpm
EA ./textures/walkstone.xpm

F 200,200,200
C 135,206,235




                                    111111
                                    100001
        111111111  11111111111111111100001
         100000001  1000000000000000000001
         101100001111000000011111111111111
11111111110000000000000000011111
10000000111100010000N00001001
100000001  100110101110000001
10000000111110000001 10100001
11111111111111111111 11111111