NO textures/test/north.xpm
SO textures/test/south.xpm
WE textures/test/west.xpm
EA textures/test/east.xpm

F 200,200,200
C 0,0,0

111111111111
100000000101
100011000001
100011000001
100011000001
100000000001
100000000001                1
100000000101
100000000101
100000011111
100000111111
10N000000001
100000000001
111111111111