NO ./textures/walkstone.xpm
SO ./textures/walkstone.xpm
WE ./textures/walkstone.xpm
EA ./textures/walkstone.xpm

F 220,100,0
C 0,200,0










































         1111111111111111111111111
         1000000000110000000000001
         1011000001110000000000001
         1001000000000000000000001
111111111011000001110000000000001
100000000011000001110111111111111
11110111111111011100000010001
11110111111111011101010010001
11000000110101011100000010001
10000000000000001100000010001
10000000000000001101010010001      11111111
11000001110101011111011111D1111    10000001
11110111 1110101 101111010N0111     11111111
11111111 1111111 11111111111111
